100
1 1 1 1 1	1 1 1 1 1	1 1 1 1 1	1 1 1 1 1
1 2 1 11 0 0 1 23 0 0 0 0 0 0 0 0 0 0 14 1
1 0 1 1 1 0 1 1 1 0 1 1 1 1 1 1 1 1 1 1
1 0 0 10 1 20 1 26 1 0 1 1 52 1 16 0 1 1 1 1
1 1 1 1 1 1 1 0 1 0 51 1 0 0 1 0 1 25 1 1
1 0 0 0 0 1 30 0 1 1 1 1 1 0 1 0 1 0 0 1
1 0 1 1 0 1 1 1 1 0 0 60 1 0 1 0 1 1 0 1
1 0 21 1 0 1 0 0 0 0 1 0 1 0 1 0 0 1 0 1
1 1 1 1 0 1 0 1 1 50 1 0 1 0 1 1 0 0 0 1
1 0 0 0 0 1 0 1 1 1 1 0 0 0 62 1 1 1 1 1
1 0 0 1 1 1 0 1 17 0 1 1 1 1 0 0 0 0 0 1
1 12 13 1 0 0 0 1 0 0 0 0 0 1 1 1 1 1 0 1
1 1 1 1 0 1 1 1 1 1 1 1 0 63 1 0 0 0 0 1
1 22 24 1 0 1 27 0 0 0 0 0 1 0 1 0 1 1 1 1
1 0 0 1 0 1 1 1 1 1 1 0 1 0 1 0 41 0 53 1
1 0 1 1 0 1 0 0 0 0 0 0 1 0 0 0 1 1 1 1
1 0 0 1 0 1 0 1 1 1 1 1 1 1 1 1 1 0 1 1
1 1 61 1 40 1 0 1 42 1 0 0 0 1 0 0 0 0 0 1
1 31 0 15 1 32 0 1 0 0 0 1 0 0 0 1 0 1 0 3
1 1 1 1 1 1 1 1 1 1 1 1 1 1 1 1 1 1 1 1